######
####B#
#### #
## # #
#    #
A ####
